11111111111111
10000C000P0001
1000E000000001
10000000C00011
10010001000001
10000C00C10001
11111111111111