1111111111111111
1C00000E00010001
100000P0001C0001
10000000000000011111111111111111
1111111111111111